{
  "easy": {
    "1": [1, 2, 3, 7, 4, 5, 0, 8, 6],
    "2": [1, 3, 5, 4, 2, 0, 7, 8, 6],
    "3": [4, 1, 2, 7, 0, 3, 8, 6, 5],
    "4": [1, 5, 2, 7, 4, 3, 0, 8, 6],
    "5": [4, 2, 0, 1, 5, 3, 7, 8, 6]
  },
  "medium": {
    "1": [7, 2, 4, 5, 0, 6, 8, 3, 1],
    "2": [0, 1, 2, 7, 8, 3, 6, 5, 4],
    "3": [5, 4, 3, 0, 1, 2, 8, 7, 6],
    "4": [8, 1, 2, 0, 4, 3, 7, 6, 5],
    "5": [3, 2, 1, 6, 5, 4, 0, 8, 7]
  },
  "hard": {
    "1": [8, 6, 7, 2, 5, 4, 3, 0, 1],
    "2": [6, 4, 7, 8, 5, 0, 3, 2, 1],
    "3": [8, 7, 6, 5, 4, 3, 2, 1, 0],
    "4": [1, 2, 3, 4, 5, 6, 7, 8, 0],
    "5": [0, 8, 7, 6, 5, 4, 3, 2, 1]
  }
}
